########################
#                      #
#         B            #
#                      #
#         BBB          #
#         R            #
#                      #
#             C         #
#                      #
#           R          #
#                      #
########################